11111111111111111
100000000000P0001
1000000C00E00C001
10000000000000001
10000000000000001
11111111111111111