11111111111111111
10000000P00000001
1000000C00000C001
100000000E0000001
10000000000000001
11111111111111111