11111111111111111
1000000000P000001
1000001C11E10C001
10000001001000001
10000000000000001
11111111111111111