11111111111111111
1001000000P000011
1000001C11E10C011
11000001001000001
10000000010000011
11111111111111111