11111111111111111
100100000001P1001
1000000011E101001
11000001001101001
10000000100101001
10000000000101001
10000010111001001
11000001001001001
10000000100011001
10010000000000001
10000010110100001
11000001001000001
100000001000H0001
10010000000000001
10000010110100001
11000001001000001
10000000000000001
11111111111111111