111111111111111111
1H01000000001P1C01
100100001101101001
110000010010101001
100000001000101001
100000000000101001
100000101101101001
110000000000001001
100000011111111001
100100000000000001
100000101101000001
1100C0010010000001
100000001000000001
1E01000000D00C0001
100000101101000001
110000010010000001
100000000000000001
111111111111111111