111111111111111111111111111111111111111111111111111111111111111111111111111111111
1001000000001P1C00000000000000000000000000000000000000000000000000000000000000001
100100001101101000000000000000000000000000000000000000000000000000000000000000001
110000010E10101000000000000000000000000000000000000000000000000000000000000000001
100000001000101000000000000000000000000000000000000000000000000000000000000000001
100000000000101000000000000000000000000000000000000000000000000000000000000000001
100000101101101000000000000000000000000000000000000000000000000000000000000000001
110000000000001000000000000000000000000000000000000000000000000000000000000000001
100000011111111000000000000000000000000000000000000000000000000000000000000000001
100100000000010000000000000000000000000000000000000000000000000000000000000000001
100000101101010000000000000000000000000000000000000000000000000000000000000000001
1100C0010010010000000000000000000000000000000000000000000000000000000000000000001
100000001111110000000000000000000000000000000000000000000000000000000000000000001
1001000000D0000000000000000000000000000000000000000000000000000000000000000000001
100000101101000H00000000000000000000000000000000000000000000000000000000000000001
111100010010000000000000000000000000000000000000000000000000000000000000000000001
100000000000000000000000000000000000000000000000000000000000000000000000000000001
111111111111111111111111111111111111111111111111111111111111111111111111111111111