11111111111111111
1001000000P000001
1000001C11E100001
11000001001000001
100000001000D0001
10010000000001001
10C00010110100001
11000001001000001
11111111111111111