11111111111111111
1001000000P000001
1000010C11E100001
11010001000111001
111101010001D0001
11010101110111001
10C00010110101001
11000001000111001
11111111111111111