11111111111111111111111111
1EN10000000000010101010101
11000P00110000010101010101
11000001000000010101010101
100000C0100000010101010101
10D00000000000010101010101
10E00010110000010101010101
11000001000000010101010101
1000C000100000010101010101
10010000000000010101010101
10010000000000010101010101
10010000000000010101010101
10010000000000010101010101
10010000000000010101010101
10010000000000010101010101
10010000000000010101010101
10C10000000000010101010101
11111111111111111111111111