11111111111111111
1001000000P000001
1000001C11E100001
11000001001000001
10000000100000001
10010000000000001
10000010110100001
11000001001000001
11111111111111111