11111111111111111
1001000000001P1C1
10000000110110101
11000001001010101
10000000100010101
10000000000010101
10000010110110101
1100000000000D101
10000001111111101
10010000000000001
10000010110100001
1100C001001000001
10000000100000001
1E01000000000C001
1D000010110100001
11000001001000001
100C0000000000C01
11111111111111111