11111111111111111
10010000000000001
1000000011E100001
11000001001000001
10000000100000001
10000C00000000C01
10000010110100001
11000001001000001
10000000100000001
10010000000000001
10000010110100001
1100C001001000001
10000000100000001
10010000P0000C001
1D000010110100001
11000001001000001
10000000000000001
11111111111111111