111111111111111111
1001000000001P1C01
100100001101101001
110000010E10101001
100000001000101001
100000000000101001
100000101101101001
110000000000001001
100000011111111001
100100000000010001
100000101101010001
1100C0010010010001
100000001111110001
1001000000D0000001
100000101101000001
111100010010000001
100000000000000001
111111111111111111