11111111111111111
1001000000P000011
1000001C11E1C0011
11000001001000001
10000000C10000011
11111111111111111